1111111111111
1P0000C000E01
1011110111101
1001000000001
1111011111001
1C00010000001
101111101C001
1111111111111
