111111111111111111111
1P00001000000001000E1
101111011111110111101
100000010000010000001
111110111110111111101
1C0000000001000000001
101111111011111110111
100000000010000000011
101111110111111110111
1C0000000000000000C11
111111101111110111111
1C0000000000000000011
111111111111111111111
