1111111111111111111111111
1P00000000100000000000001
1011111110101111111111101
1000000010100000000010001
1111101011111011111011101
1000101C00001010111111111
1011101111101010111111101
10000000001000C0000000001
1111111110111111111011101
1C000000001000000001000E1
1010000000000000000000001
1111111111111111111111111
