111111111
1000000E1
111011101
1C001P001
101111101
1P00000C1
1111111
