11111111111111
1P00001000C0E1
10101110101101
1C000100000001
11101011101011
10000010010001
10111011101101
1C0000C0000001
10111111111001
11111111111111
