11111
1C011
11P11
110E1
11111
