11111111111111
1P00C000C00001
101111101111E1
10C000010000C1
11101011101011
10001000000001
1011101C111101
100000100000C1
1C111111000001
11111111111111
