111111111
100PCE001
100000001
111111111
